................................................
.##############################################.
.#____________________________________________#.
.#____________________________________________#.
.#____________________________________________#.
.#____________________________________________#.
.#____________________________________________#.
.#____________________________________________#.
.#____________________________________________#.
.#____________________________________________#.
.#____________________#######_________________#.
.#____________________#.....#_________________#.
.#____________________#.....#_________________#.
.#____________________#.....#_________________#.
.#____________________#######_________________#.
.#____________________________________________#.
.#____________________________________________#.
.#____________________________________________#.
.#____________________________________________#.
.#____________________________________________#.
.#____________________________________________#.
.#____________________________________________#.
.#____________________________________________#.
.#____________________________________________#.
.#____________________________________________#.
.#____________________________________________#.
.#____________________________________________#.
.#____________________________________________#.
.#____________________________________________#.
.#____________________________________________#.
.#____________________________________________#.
.#____________________________________________#.
.#____________________________________________#.
.#____________________________________________#.
.#____________________________________________#.
.#____________________________________________#.
.#____________________________________________#.
.#____________________________________________#.
.#____________________________________________#.
.#____________________________________________#.
.#____________________________________________#.
.#____________________________________________#.
.#____________________________________________#.
.#____________________________________________#.
.#____________________________________________#.
.#____________________________________________#.
.##############################################.
................................................
