................................................
.##############################################.
.#____________________________________________#.
.#____________________________________________#.
.#_____x______________________________________#.
.#____________________________________________#.
.#____________________________________________#.
.#____________________________________________#.
.#____________________________________________#.
.#____________________________________________#.
.#____________________#######_________________#.
.#____________________#.....#_______T_________#.
.#_______T____________#.....#_________________#.
.#____________________#.....#_________________#.
.#____________________#######_________________#.
.#____________________________________________#.
.#____________________________________________#.
.#_____________________T______________________#.
.#____________________________________________#.
.#____________________________________________#.
.#_____________________________________T______#.
.#____________________________________________#.
.#______###___________________________________#.
.#______#.#___________________________________#.
.#______#.#_____________T_____________________#.
.#______#.#___________________________________#.
.#______#.#___________________________________#.
.#______#.#___________________________________#.
.#______#.##__________________________________#.
.#______#..##_________________________________#.
.#______#...#######################___________#.
.#______#.........................#___________#.
.#______###########################___________#.
.#____________________________________________#.
.#____________________________________________#.
.#____________________________________________#.
.#____________________________________________#.
.#____________________________________________#.
.#____________________________________________#.
.#____________________________________________#.
.#____________________________________________#.
.#____________________________________________#.
.#_____________________######___________@_____#.
.#_____________________#....#_________________#.
.#_____________________#....#_________________#.
.#_____________________#....#_________________#.
.#######################....###################.
................................................
